R 700 500
NO ./texture/greystone.xpm
SO ./texture/eagle.xpm
WE ./texture/purplestone.xpm
EA ./texture/redbrick.xpm

S ./texture/barrel.xpm
F 92, 92, 92
C 148, 227, 224

1111111111111111111111111
1000000000000000000000001
1000000000000000000000001
1000000000000000000000001
100000000000N000000000001
1000000000000000000000001
1000000000000000000000001
1111111111111111111111111
