
NO ./texture/darker_wall.xpm
SO ./texture/door_wall.xpm
WE ./texture/normal_wall.xpm
EA ./texture/normal_wall.xpm

S ./texture/player_green.xpm
G ./texture/player_green_dead.xpm
T ./texture/player_blue.xpm
H ./texture/player_blue_dead.xpm
U ./texture/player_red.xpm
I ./texture/player_red_dead.xpm
V ./texture/player_black.xpm
J ./texture/player_black_dead.xpm
W ./texture/player_orange.xpm
K ./texture/player_orange_dead.xpm
a ./texture/player_white.xpm
L ./texture/player_white_dead.xpm
b ./texture/player_brown.xpm
M ./texture/player_brown_dead.xpm
c ./texture/player_light_blue.xpm
N ./texture/player_light_blue_dead.xpm
d ./texture/player_lime.xpm
O ./texture/player_lime_dead.xpm
e ./texture/player_pink.xpm
P ./texture/player_pink_dead.xpm
f ./texture/player_purple.xpm
Q ./texture/player_purple_dead.xpm
g ./texture/player_yellow.xpm
h ./texture/player_yellow_dead.xpm

k ./texture/bad_brown.xpm
l ./texture/bad_green.xpm
m ./texture/bad_pink.xpm
n ./texture/heart.xpm
o ./texture/scan.xpm

. ./texture/heal_cross.xpm
, ./texture/heal_wall.xpm
_ ./texture/heal_control.xpm
@ ./texture/wall_control.xpm
# ./texture/technic.xpm
$ ./texture/window.xpm

F 92,92,92
C 94,91,140

11111111111111111111111111111$$$$$$$$11111111111111111111
111111111111111111111111111110000000011111111111111111111
1111111111111111111111111111000200000011111@$111111111111
111111111111111111111111111000000000000111100$11111111111
1111111111111111111111111100020000002000111000$1111111111
11111111110001111111111111020000000000000110000$111111111
111111111000011111111111110000000000000001100000$11111111
111111110000040000000000040000000000000004000020111111111
111111110000011111,.4.,1110000000000000001100000111111111
11111111000001111,00000,110000000000000001110000111111111
1111@111000001111,00000,110000000000000001111101111111111
11110011114111111,00000.112000000N0000001#000141111111111
11100011110111111.000000,110000000000001100001011111###11
11000011110111@11,0000000,11000000000033000004000011000$1
10000000110110001,0000000_111000000001110000011110110000@
100000001101002001,0020o00,111111411111#@@#1111110040020@
1000000011010000011,000000,11111100400000001111110110000@
#0000000400400000111,,,,,,11111110110000000111100011000$1
10000000110100000111####1111111114110000000111101111###11
100000001101000001110000011111100001000002011110111111111
100000001101000003330000011111000001000000111114111111111
110000111101111111110000011110000001000001111100001111111
111000111101111111110000011100000001111111111000001111111
111100111141111111111110011100000001111111110000001111111
1111@1110000011111110000011100000004000000040000001111111
111111110000011111110000011#00000001111141110000001111111
111111110000040001110000111#0020000100l0000100000$1111111
111111110000011101110001111100000001000000010000$11111111
1111111110000111011141111111000000010k0000m1200$111111111
11111111110001110000000000040000000#000000011111111111111
111111111111111111111111111110000001100000111111111111111
11111111111111111111111111111100000111@@11111111111111111
111111111111111111111111111111100001111111111111111111111
1111111111111111111111111111111$$111111111111111111111111
